11111111111111111111111111111111111111111111111111
01000000000010100000000110100000001001000000010001
11000000000100000100000001011000101001000100001001
10001000001010000000000100000000001000010100001001
10000010000110000010000000000010000100000010100001
11000010001010000001000000100000100001000000000001
10100010000000000100010001110010000000000000101101
10000100001110110000010000001000100000010100000001
10001000001001000000100000100010000000100000000001
10000000001000100001001000100010100000000100111001
11010001001001010000000001010000000000000000000001
10000000011000000000011000110010000000100000000111
10001110001000001001000000000000001010000000100001
10001010000100110001000010010000000000100111100101
11011000100000010000100001001000000000000100101101
10010000100000000100000010000101110011001000111001
10001100000000000001000000111100000001001000011001
10010000001001000100011010100000001000100001000011
11000110010100010010110000010101000000000000001101
10000010001000101000100011000000000010000100110011
10011101100000001000110000100100000000010100011001
10010001000000001010000000000001100000000000000101
10001000000100000010000000100111010000000001100111
11000001010000001000010010000000000000101000000101
11011100001100000000000000000110000000000100100001
10001011000000101000000100010010001001000101001001
11100000100000100010000000001001000100100000001001
10001001000000010000010010001000001001001000010001
10100101000000000000000010000000001000001000000111
10001001010001010010000010000010000010000010000001
10001010000010000000100001000100011001000001000001
10001000000000010000000000010000011100000011000001
10000000100010000000001000000001000010000010000011
11100000001010000000000000000000011000110000000001
10001000110000010000010000100100001000000000000111
10001000001000000100000000100000101010000001001001
11000110000000100000000000000000001000000000110011
10001001010010000000010000101000010110100100010001
10100000000011000000001011000000010100000000000101
10000100000001000111000000000001000000000000000011
10001011000001001100000001100010001000001010000011
10100000000000010000010100110000001010110000011001
10000000110001100011000000010000000000010001000001
10001000000000000000011011110000000101010110000001
10000100101000001000000000000110010000110001000001
10000000000011111000010000000101011111000000000101
11001000110010100000000010010000000000011100000011
10000000000000000000010001000000100011111100000001
10101001000001000010000010000000000100100011000100
11111111111111111111111111111111111111111111111111
